mongo admin --eval 'db.createUser({user: "ml5642", pwd: 	"indigo", "roles" : [ { "role" : "root", "db" : "admin" }]})'
mongo admin --eval 'db.createUser({user: "kt2770", pwd: 	"dark_goldenrod", "roles" : [ { "role" : "root", "db" : "admin" }]})'
mongo admin --eval 'db.createUser({user: "dr3555", pwd: 	"light_steel_blue", "roles" : [ { "role" : "root", "db" : "admin" }]})'
mongo admin --eval 'db.createUser({user: "kc3592", pwd: 	"firebrick", "roles" : [ { "role" : "root", "db" : "admin" }]})'
mongo admin --eval 'db.createUser({user: "ch8600", pwd: 	"sienna", "roles" : [ { "role" : "root", "db" : "admin" }]})'
mongo admin --eval 'db.createUser({user: "el9292", pwd: 	"brown", "roles" : [ { "role" : "root", "db" : "admin" }]})'
mongo admin --eval 'db.createUser({user: "lm4863", pwd: 	"goldenrod", "roles" : [ { "role" : "root", "db" : "admin" }]})'
mongo admin --eval 'db.createUser({user: "cp2617", pwd: 	"indigo", "roles" : [ { "role" : "root", "db" : "admin" }]})'
mongo admin --eval 'db.createUser({user: "sc8796", pwd: 	"rosy_brown", "roles" : [ { "role" : "root", "db" : "admin" }]})'
mongo admin --eval 'db.createUser({user: "dd1611", pwd: 	"silver", "roles" : [ { "role" : "root", "db" : "admin" }]})'
mongo admin --eval 'db.createUser({user: "jw3928", pwd: 	"dodger_blue", "roles" : [ { "role" : "root", "db" : "admin" }]})'
mongo admin --eval 'db.createUser({user: "kw8956", pwd: 	"silver", "roles" : [ { "role" : "root", "db" : "admin" }]})'
mongo admin --eval 'db.createUser({user: "gb6038", pwd: 	"light_sky_blue", "roles" : [ { "role" : "root", "db" : "admin" }]})'
mongo admin --eval 'db.createUser({user: "sh5016", pwd: 	"dark_violet", "roles" : [ { "role" : "root", "db" : "admin" }]})'
mongo admin --eval 'db.createUser({user: "rw6558", pwd: 	"lawn_green", "roles" : [ { "role" : "root", "db" : "admin" }]})'
mongo admin --eval 'db.createUser({user: "jc4930", pwd: 	"dark_sea_green", "roles" : [ { "role" : "root", "db" : "admin" }]})'
mongo admin --eval 'db.createUser({user: "av7759", pwd: 	"cornsilk", "roles" : [ { "role" : "root", "db" : "admin" }]})'
mongo admin --eval 'db.createUser({user: "sr7445", pwd: 	"lavender_blush", "roles" : [ { "role" : "root", "db" : "admin" }]})'
mongo admin --eval 'db.createUser({user: "pg8821", pwd: 	"gold", "roles" : [ { "role" : "root", "db" : "admin" }]})'
mongo admin --eval 'db.createUser({user: "db1055", pwd: 	"web_green", "roles" : [ { "role" : "root", "db" : "admin" }]})'
mongo admin --eval 'db.createUser({user: "hb6182", pwd: 	"papaya_whip", "roles" : [ { "role" : "root", "db" : "admin" }]})'
mongo admin --eval 'db.createUser({user: "jl4182", pwd: 	"dark_olive_green", "roles" : [ { "role" : "root", "db" : "admin" }]})'
mongo admin --eval 'db.createUser({user: "lk7535", pwd: 	"dark_red", "roles" : [ { "role" : "root", "db" : "admin" }]})'
mongo admin --eval 'db.createUser({user: "cs1163", pwd: 	"green", "roles" : [ { "role" : "root", "db" : "admin" }]})'
mongo admin --eval 'db.createUser({user: "jm3909", pwd: 	"blue_violet", "roles" : [ { "role" : "root", "db" : "admin" }]})'
mongo admin --eval 'db.createUser({user: "ml2943", pwd: 	"dark_orchid", "roles" : [ { "role" : "root", "db" : "admin" }]})'
mongo admin --eval 'db.createUser({user: "tm3562", pwd: 	"light_yellow", "roles" : [ { "role" : "root", "db" : "admin" }]})'
mongo admin --eval 'db.createUser({user: "sa2940", pwd: 	"linen", "roles" : [ { "role" : "root", "db" : "admin" }]})'
mongo admin --eval 'db.createUser({user: "tt5286", pwd: 	"cyan", "roles" : [ { "role" : "root", "db" : "admin" }]})'
mongo admin --eval 'db.createUser({user: "zc7068", pwd: 	"dark_khaki", "roles" : [ { "role" : "root", "db" : "admin" }]})'
mongo admin --eval 'db.createUser({user: "kb1083", pwd: 	"moccasin", "roles" : [ { "role" : "root", "db" : "admin" }]})'
mongo admin --eval 'db.createUser({user: "kr5370", pwd: 	"dark_green", "roles" : [ { "role" : "root", "db" : "admin" }]})'
mongo admin --eval 'db.createUser({user: "ko9866", pwd: 	"web_maroon", "roles" : [ { "role" : "root", "db" : "admin" }]})'
mongo admin --eval 'db.createUser({user: "tr4799", pwd: 	"light_sky_blue", "roles" : [ { "role" : "root", "db" : "admin" }]})'
mongo admin --eval 'db.createUser({user: "ns6008", pwd: 	"deep_sky_blue", "roles" : [ { "role" : "root", "db" : "admin" }]})'
mongo admin --eval 'db.createUser({user: "lb2095", pwd: 	"pale_green", "roles" : [ { "role" : "root", "db" : "admin" }]})'
mongo admin --eval 'db.createUser({user: "lt1286", pwd: 	"light_slate_gray", "roles" : [ { "role" : "root", "db" : "admin" }]})'
mongo admin --eval 'db.createUser({user: "ts8296", pwd: 	"blanched_almond", "roles" : [ { "role" : "root", "db" : "admin" }]})'
mongo admin --eval 'db.createUser({user: "cb1864", pwd: 	"sienna", "roles" : [ { "role" : "root", "db" : "admin" }]})'
mongo admin --eval 'db.createUser({user: "tm3808", pwd: 	"teal", "roles" : [ { "role" : "root", "db" : "admin" }]})'
mongo admin --eval 'db.createUser({user: "hm2491", pwd: 	"thistle", "roles" : [ { "role" : "root", "db" : "admin" }]})'
mongo admin --eval 'db.createUser({user: "fb2923", pwd: 	"khaki", "roles" : [ { "role" : "root", "db" : "admin" }]})'
mongo admin --eval 'db.createUser({user: "dd4319", pwd: 	"white_smoke", "roles" : [ { "role" : "root", "db" : "admin" }]})'
mongo admin --eval 'db.createUser({user: "rw8593", pwd: 	"papaya_whip", "roles" : [ { "role" : "root", "db" : "admin" }]})'
mongo admin --eval 'db.createUser({user: "ar7921", pwd: 	"olive", "roles" : [ { "role" : "root", "db" : "admin" }]})'
mongo admin --eval 'db.createUser({user: "zc7682", pwd: 	"dark_gray", "roles" : [ { "role" : "root", "db" : "admin" }]})'
mongo admin --eval 'db.createUser({user: "mb6540", pwd: 	"goldenrod", "roles" : [ { "role" : "root", "db" : "admin" }]})'
mongo admin --eval 'db.createUser({user: "dm9203", pwd: 	"hot_pink", "roles" : [ { "role" : "root", "db" : "admin" }]})'
mongo admin --eval 'db.createUser({user: "ls9367", pwd: 	"pale_goldenrod", "roles" : [ { "role" : "root", "db" : "admin" }]})'
mongo admin --eval 'db.createUser({user: "jv2549", pwd: 	"floral_white", "roles" : [ { "role" : "root", "db" : "admin" }]})'
mongo admin --eval 'db.createUser({user: "km9470", pwd: 	"chartreuse", "roles" : [ { "role" : "root", "db" : "admin" }]})'
mongo admin --eval 'db.createUser({user: "kt5993", pwd: 	"ivory", "roles" : [ { "role" : "root", "db" : "admin" }]})'
mongo admin --eval 'db.createUser({user: "zg9762", pwd: 	"dark_orchid", "roles" : [ { "role" : "root", "db" : "admin" }]})'
mongo admin --eval 'db.createUser({user: "mo6049", pwd: 	"medium_aquamarine", "roles" : [ { "role" : "root", "db" : "admin" }]})'
mongo admin --eval 'db.createUser({user: "qm3155", pwd: 	"forest_green", "roles" : [ { "role" : "root", "db" : "admin" }]})'
mongo admin --eval 'db.createUser({user: "nr7466", pwd: 	"dark_orange", "roles" : [ { "role" : "root", "db" : "admin" }]})'
mongo admin --eval 'db.createUser({user: "es3174", pwd: 	"light_yellow", "roles" : [ { "role" : "root", "db" : "admin" }]})'
mongo admin --eval 'db.createUser({user: "km2394", pwd: 	"magenta", "roles" : [ { "role" : "root", "db" : "admin" }]})'
mongo admin --eval 'db.createUser({user: "tp9002", pwd: 	"lawn_green", "roles" : [ { "role" : "root", "db" : "admin" }]})'
mongo admin --eval 'db.createUser({user: "be8354", pwd: 	"light_cyan", "roles" : [ { "role" : "root", "db" : "admin" }]})'
mongo admin --eval 'db.createUser({user: "am9754", pwd: 	"dark_salmon", "roles" : [ { "role" : "root", "db" : "admin" }]})'
mongo admin --eval 'db.createUser({user: "hu5023", pwd: 	"ivory", "roles" : [ { "role" : "root", "db" : "admin" }]})'
mongo admin --eval 'db.createUser({user: "mc7401", pwd: 	"dark_khaki", "roles" : [ { "role" : "root", "db" : "admin" }]})'
mongo admin --eval 'db.createUser({user: "gm6768", pwd: 	"light_gray", "roles" : [ { "role" : "root", "db" : "admin" }]})'
mongo admin --eval 'db.createUser({user: "ap2963", pwd: 	"dark_sea_green", "roles" : [ { "role" : "root", "db" : "admin" }]})'
mongo admin --eval 'db.createUser({user: "ac3699", pwd: 	"sandy_brown", "roles" : [ { "role" : "root", "db" : "admin" }]})'
mongo admin --eval 'db.createUser({user: "mc2860", pwd: 	"light_steel_blue", "roles" : [ { "role" : "root", "db" : "admin" }]})'
mongo admin --eval 'db.createUser({user: "cs6997", pwd: 	"lime_green", "roles" : [ { "role" : "root", "db" : "admin" }]})'
mongo admin --eval 'db.createUser({user: "as4599", pwd: 	"lime", "roles" : [ { "role" : "root", "db" : "admin" }]})'
mongo admin --eval 'db.createUser({user: "sc6522", pwd: 	"white", "roles" : [ { "role" : "root", "db" : "admin" }]})'
mongo admin --eval 'db.createUser({user: "gs4973", pwd: 	"light_gray", "roles" : [ { "role" : "root", "db" : "admin" }]})'
mongo admin --eval 'db.createUser({user: "st1053", pwd: 	"aqua", "roles" : [ { "role" : "root", "db" : "admin" }]})'
mongo admin --eval 'db.createUser({user: "aj4576", pwd: 	"medium_violet_red", "roles" : [ { "role" : "root", "db" : "admin" }]})'
mongo admin --eval 'db.createUser({user: "sq1579", pwd: 	"dodger_blue", "roles" : [ { "role" : "root", "db" : "admin" }]})'
mongo admin --eval 'db.createUser({user: "hc7123", pwd: 	"white", "roles" : [ { "role" : "root", "db" : "admin" }]})'
mongo admin --eval 'db.createUser({user: "jp7902", pwd: 	"light_salmon", "roles" : [ { "role" : "root", "db" : "admin" }]})'
mongo admin --eval 'db.createUser({user: "fb6402", pwd: 	"papaya_whip", "roles" : [ { "role" : "root", "db" : "admin" }]})'
mongo admin --eval 'db.createUser({user: "ob5417", pwd: 	"snow", "roles" : [ { "role" : "root", "db" : "admin" }]})'
mongo admin --eval 'db.createUser({user: "dg7156", pwd: 	"medium_orchid", "roles" : [ { "role" : "root", "db" : "admin" }]})'
mongo admin --eval 'db.createUser({user: "sc9265", pwd: 	"red", "roles" : [ { "role" : "root", "db" : "admin" }]})'
mongo admin --eval 'db.createUser({user: "iv9571", pwd: 	"dark_orange", "roles" : [ { "role" : "root", "db" : "admin" }]})'
mongo admin --eval 'db.createUser({user: "rr5021", pwd: 	"light_cyan", "roles" : [ { "role" : "root", "db" : "admin" }]})'
mongo admin --eval 'db.createUser({user: "cc8699", pwd: 	"lawn_green", "roles" : [ { "role" : "root", "db" : "admin" }]})'
mongo admin --eval 'db.createUser({user: "ec6663", pwd: 	"white", "roles" : [ { "role" : "root", "db" : "admin" }]})'
mongo admin --eval 'db.createUser({user: "kf1843", pwd: 	"burlywood", "roles" : [ { "role" : "root", "db" : "admin" }]})'
mongo admin --eval 'db.createUser({user: "rs5737", pwd: 	"indian_red", "roles" : [ { "role" : "root", "db" : "admin" }]})'
mongo admin --eval 'db.createUser({user: "eb8502", pwd: 	"blue", "roles" : [ { "role" : "root", "db" : "admin" }]})'
mongo admin --eval 'db.createUser({user: "rn4499", pwd: 	"hot_pink", "roles" : [ { "role" : "root", "db" : "admin" }]})'
mongo admin --eval 'db.createUser({user: "dr3817", pwd: 	"medium_turquoise", "roles" : [ { "role" : "root", "db" : "admin" }]})'
mongo admin --eval 'db.createUser({user: "cl6104", pwd: 	"dark_cyan", "roles" : [ { "role" : "root", "db" : "admin" }]})'
mongo admin --eval 'db.createUser({user: "tm2997", pwd: 	"rosy_brown", "roles" : [ { "role" : "root", "db" : "admin" }]})'
mongo admin --eval 'db.createUser({user: "al7542", pwd: 	"light_blue", "roles" : [ { "role" : "root", "db" : "admin" }]})'
mongo admin --eval 'db.createUser({user: "as8786", pwd: 	"blue_violet", "roles" : [ { "role" : "root", "db" : "admin" }]})'
mongo admin --eval 'db.createUser({user: "ca3216", pwd: 	"pale_goldenrod", "roles" : [ { "role" : "root", "db" : "admin" }]})'
mongo admin --eval 'db.createUser({user: "az9113", pwd: 	"cornflower_blue", "roles" : [ { "role" : "root", "db" : "admin" }]})'
mongo admin --eval 'db.createUser({user: "br5561", pwd: 	"saddle_brown", "roles" : [ { "role" : "root", "db" : "admin" }]})'
mongo admin --eval 'db.createUser({user: "yc1145", pwd: 	"hot_pink", "roles" : [ { "role" : "root", "db" : "admin" }]})'
mongo admin --eval 'db.createUser({user: "yw9566", pwd: 	"pale_violet_red", "roles" : [ { "role" : "root", "db" : "admin" }]})'
mongo admin --eval 'db.createUser({user: "rp6606", pwd: 	"rebecca_purple", "roles" : [ { "role" : "root", "db" : "admin" }]})'
mongo admin --eval 'db.createUser({user: "gt3890", pwd: 	"magenta", "roles" : [ { "role" : "root", "db" : "admin" }]})'
